############################################################
############################################################
##........................................................##
##........22@222...........22@222.......!.......22@222....##
##..!.....222222.....!.....222222...............222222....##
##........222222...........222222222222222222222222222....##
##........22222222222222222222222...............222222....##
##........222222...........222222...............222222....##
##.............2................2................2........##
##.....!.......2................2........!.......2........##
##.............2.........!......2................2........##
##.............2................2................2........##
##.............2................2................2........##
##...!....22@222..............22@222.........22@222.......##
##........222222..............222222.........222222.......##
##........22222222222222222222222222.........222222.......##
##........222222........2.....222222.........222222.......##
##........222222........2.....222222.........222222.......##
##.....!...2............2.....222222222222222222222.......##
##.........2.........222222.............2.................##
##.........2.........222222.............2............!....##
##.........2.........222222.............2.................##
##.........222@22....222222.....22@222..2.......22@222....##
##.........222222222222222222222222222..2.......222222....##
##....!.....22222...............2222222222222222222222....##
##..........22222...............222222..........222222....##
##..........22222...............222222..........222222....##
##............2..................2........!.........2.....##
##......!.....2..................2..................2.....##
##.........22@222.........22@22222..............22@222....##
##.........222222.........222222................222222....##
##.........2222222222222222222222222222222222222222222....##
##.........222222.........222222................222222....##
##........................................................##
##.....!.............!..................!............!....##
##........................................................##
############################################################
############################################################