############################################################222222222222
############################################################222222222222
##........................................................##222222222222
##........................................................##222222222222
##........................................................##222222222222
##........................................................##222222222222
##........................................................##222222222222
##........................................................##222222222222
##........................................................##222222222222
##........................................................##222222222222
##........................................................##222222222222
##........................................................##222222222222
##........................................................##222222222222
##........................................................##222222222222
##........................................................##222222222222
##......................................................................
##......................................................................
##........................................................##222222222222
##........................................................##222222222222
##........................................................##222222222222
##........................................................##222222222222
##........................................................##222222222222
##........................................................##222222222222
##........................................................##222222222222
##........................................................##222222222222
##........................................................##222222222222
##........................................................##222222222222
##........................................................##222222222222
##........................................................##222222222222
##........................................................##222222222222
##........................................................##222222222222
##........................................................##222222222222
##........................................................##222222222222
##........................................................##222222222222
##........................................................##222222222222
##........................................................##222222222222
############################################################222222222222
############################################################222222222222